# Mapa do Labirinto - 0=parede, 1=corredor, 2=sala, 3=inicio do jogador
# Valores adicionais: 4=janela, 5=porta, 6=objeto estático, 7=cápsula de energia
# Dimensões: 20x20 (cada célula = 1m)
20 20
1 1 1 1 1 1 1 1 1 1 1 1 1 1 1 1 1 1 1 1
1 1 1 1 1 7 1 6 1 1 1 7 1 1 1 6 1 7 1 1
1 1 1 1 1 1 1 1 1 1 1 1 1 1 1 1 1 1 1 1
1 1 1 1 4 1 1 1 1 1 1 1 1 5 1 1 1 1 1 1
1 1 6 1 1 1 7 1 1 1 6 1 1 1 1 1 1 7 1 1
1 1 1 1 1 1 1 1 0 1 1 1 1 1 1 1 1 1 1 1
1 7 1 1 1 1 1 6 1 1 1 1 7 1 1 1 1 1 1 1
1 1 1 1 1 1 1 1 1 1 1 1 1 1 1 1 1 1 1 1
1 1 1 6 1 1 1 1 1 1 1 1 1 1 1 1 1 1 7 1
1 1 1 1 1 1 1 1 1 3 1 1 1 1 1 1 1 1 1 1
1 1 1 1 1 1 1 1 1 1 1 1 6 1 1 1 1 1 1 1
1 1 1 1 1 7 1 1 1 1 1 1 1 1 1 1 1 6 1 1
1 1 1 1 1 1 1 1 1 1 1 1 1 1 7 1 1 1 1 1
1 6 1 1 1 1 1 1 1 1 1 1 1 1 1 1 1 1 1 1
1 1 1 1 1 1 6 1 1 1 1 1 1 1 1 1 7 1 1 1
1 1 1 1 1 1 1 1 1 1 1 1 1 1 1 1 1 1 1 1
1 1 7 1 1 1 1 1 1 1 1 1 1 6 1 1 1 1 1 1
1 1 1 1 1 1 1 1 7 1 1 1 1 1 1 1 1 1 1 1
1 1 1 1 1 1 1 1 1 1 1 1 1 1 1 1 1 1 1 1
1 1 1 1 1 1 1 1 1 1 1 1 1 1 1 1 1 1 1 1
